000000000000000000000000000
002222000000000222200000000
001111000000000111100000000
001111000000000111100000000
001111000000000111100000000
001111000000000111100000000
001111111111111111111120000
001111111111111111111120000
001111111111111111111120000
001111111111111111111120000
000000001111000000000000000
000000001111000000000000000
000211111111111111200000000
000211111111111111200000000
000211111111111111200000000
000211111111111111200000000
000000000000011110000000000
000001111111111110000000000
000001111111111110000000000
000001111111111110000000000
000001111111111110000000000
000001111000000000000000000
000001111111120000000000000
000001111111120000000000000
000001111111120000000000000
000001111111120000000000000
000000000000000000000000000