0000000000000000000000000000
0022220000000000000000000000
0011110000000000000000000000
0011110000000000000000000000
0011110000000000000000000000
0011110000000000000000000000
0011111111111111200000000000
0011111111111111200000000000
0011111111111111200000000000
0011111111111111200000000000
0011110000000000000000000000
0011110000000000000000000000
0011111111111111111120000000
0011111111111111111120000000
0011111111111111111120000000
0011111111111111111120000000
0000000001111000000000000000
0000211111111111111200000000
0000211111111111111200000000
0000211111111111111200000000
0000211111111111111200000000
0000000001111000000000000000
0000000001111000000000000000
0000000001111000000000000000
0000000001111000000000000000
0000000002222000000000000000
0000000000000000000000000000
0000000000000000000000000000
