000000000000000000000000000000000000000000000
000000000000000000222200000000000000000000000
000000000000000000111100000000000000000000000
021111111111111111111111111111111111111200000
021111111111111111111111111111111111111200000
021111111111111111111111111111111111111200000
021111111111111111111111111111111111111200000
000000111100000000000000000001111000000000000
000000111100000000000000000001111000000000000
000000111100000000000000000001111000000000000
000000111111111111111111200001111111111120000
000000111111111111111111200001111111111120000
000000111111111111111111200001111111111120000
000000111111111111111111200001111111111120000
000000111100000000000000000001111000000000000
000000111100000000000000000001111000000000000
002111111111111111111111111111111000000000000
002111111111111111111111111111111000000000000
002111111111111111111111111111111000000000000
002111111111111111111111111111111000000000000
000000000000001111000000000001111000000000000
000000000000001111000000000001111000000000000
000000000000001111000000000001111000000000000
000000000021111111111111111111111111111000000
000000000021111111111111111111111111111000000
000000000021111111111111111111111111111000000
000000000021111111111111111111111111111000000
000000000000001111000000000000000001111000000
000000000000001111000000000000000001111000000
000000000000001111000000000000000001111000000
000001111111111111000000011111111111111111200
000001111111111111000000011111111111111111200
000001111111111111000000011111111111111111200
000001111111111111000000011111111111111111200
000001111000001111000000011110000001111000000
000001111000002222000000011110000001111000000
000001111000000000000000011110000001111000000
000001111000002222000000011110000001111000000
000001111000001111000000011111111111111000000
000001111111111111000000011111111111111000000
000001111111111111000000011111111111111000000
000001111111111111000000011111111111111000000
000001111111111111000000000000111100000000000
000000000000000000000000000000222200000000000
000000000000000000000000000000000000000000000

